xxxxxxxxxxxxxxxxxxxxxxxxxxxxxxxxxxxxxxxxxxxxxxxxxxxxxxxxx
x             x    x                                    x
x             x    x                                    x
x             xxxxxx                                    x
x                                                       x
x                                                       x
x                             P----------               x
x                             |         |               x
x                             |         |               x
x                             |         |               x
x                             -----------               x
x                                                       x
x                                                       x
x                                                       x
x                                                       x
x                                                       x
x                                                       x
x                                                       x
x                                                       x
x                                                       x
x                                                       x
x                                                       x
x                                                       x
x                                                       x
x                                                       x
x                                                       x
x                                                       x
x                                                       x
x                                                       x
x                                                       x
x                                                       x
xxxxxxxxxxxxxxxxxxxxxxxxxxxxxxxxxxxxxxxxxxxxxxxxxxxxxxxxx
